37 24
##################################
#................................#
#................................#
#................................#
#................................#
#........#######.#############...#
#........#     #.#           #...#
#........#  ####.#########   #...#
#....@...#  #............#   #...#
#........#  #.........####   #...#
#........#  #............#   #...#
#........#  #.........####   #...#
######..##  #............#   ##..#
     #..#   ##############    #..#
      #..#                    #..#
      ##..#      ########     #..#
  #####..##      #......#     #..#
  #.......#      #......#     #..#
  #.......#      #......#     #..#
  #.......########......#     ##.#
  #.....................#     ##.#
  #.......########......#     ##.#
  #.......#      #......#      ##
  #########      ########